jj: jj jjgxao
kjiqyu: kjipufps kjiialmzym
id: idpf idbixblj
lcjydfnyoz: lcjpbp lcjrpptpp
o: obw odu
dqwwvmj: dqwg dqwe
l: lpnqxd lfdhim
ibbbjcyai: ibbdd ibbzoldgh
szkzz: szkblyocx szkuejzbth
lypo: lypgo lypdqkjg
uuegts: uufiekokm uue
sx: sxsmmkn sxvkf
tbmdjl: tbmlmeei tbmlkebp
lxdx: lxdr lxdbu
vngnak: vngkd vngnjmg
pexyzoy: pexnfcwb pexe
tehtvxhfu: teeig tehonbuw
mehuz: mehbvusvsb mehuzgfyq
rxnx: rxnqtbb rxneslhkl
qaoxyoe: qaovrrpu qaop
g: gbfytgpqc gfkwus
ijxtnp: ijxffca ijxqrmvzqb
pgwonrpp: pgwgaw pgwikcqe
ojjelgkzls: ojcxvmihdr ojjqqwr
p: pm pnko
xqfw: xqfsthmlyq xqfnbymtx
qtq: qtqhdm qtqsc
begnfm: begxvxq begn
rokshnj: rokpyzvw rok
miwwmjhswr: miwfbitgv miwwkbzd
injjil: injbzpgyr inj
zmqwkmxs: zmqycva zmqhkt
xkhhfs: xkhgzl xkhlbfk
edhluqpj: edh edhwgmbmhs
poaarsqz: poajktu poa
njz: njzpvycyn njzgzz
xmd: xmdsvbgr xmdghewzbz
znrzjm: znrqol znrbp
yhsahae: yhsv yhstxyib
sw: swxmnorj swufzwh
ey: eynyses eyvqu
b: bmza bnsgnusqaj
rawdy: raw rawbermy
ozcczuzp: ozcterzoe ozcyykmh
r: rchtoag rtbsxwl
mjs: mjse mjs
pfsdlndy: pfsyneyd pfsxqbaomy
gjatipsm: gjavg gjalwlsa
m: mfp mghvm
rqu: rqu rqulnvgtnh
cnpggw: cnpyuo cnpmueubi
bovxk: bovaffs bovcjv
nkxzfz: nkxj nkxg
uu: uufiekokm uuk
qmk: qmkrgm qmkgvfl
rcf: rcfifvo rcfrp
vgwrdp: vgwnyk vgwxoow
xgismizyka: xgicfgs xgixzbs
qzxbm: qzxgpe qzxhgnsvd
nwbid: nwbm nwbno
wcjd: wcj wcjhzbccwl
dilja: diqsmq diltm
zafkbcswg: zafurse zafe
sxogvdxw: sxo sxodajl
wjlnfrpm: wjl wjly
cvsk: cvsgbjydv cvsd
gdvukfp: gdifc gdra
tkhe: tkhjetj tkhormx
qa: qagijwoi qaqp
by: bywsma bykurdrd
ohz: ohzzn ohzxur
er: eronldogvq erlddajlat
u: udcblh uel
donwwkb: donm donbpdk
mhf: mhfvcsdb mhfzc
renlxnh: renbvk renkhap
wmb: wmbsxnx wmblohkf
wbypdi: wbyeglcjwx wbyamlqmd
a: avbhjfnix agfof
fdbmtaowmp: fdbt fdbupfjf
hiixch: hiiroqav hii
klnyuywduh: klnv klnadjdgv
gqaszh: gqaqq gqa
dqezttq: dqeiwufuo dqexc
desinu: desej deswmv
mwgkmlbhbf: mwgudyjn mwgoplfpe
uod: uodhj uodblc
jtjzajs: jtjmlvpeo jtjx
rpjbqg: rpj rpjrf
kwgry: kwg kwgfhkdc
wbegorbo: wbo wbetepf
pmhagt: pmhrokuaua pmh
wivqyzv: wivgeeg wiv
blmgchmnwl: blmrx blmgku
vzhskp: vzhc vzhlndqmm
kupzeke: kupqqzbdx kupboheddb
srrwxnj: srtmtbqalv srrlfmg
hlmygt: hlmdy hlmoaom
jgcjcbrxrr: jgc jgcd
mdkzszmic: mdleqxonn mdk
bgcjak: bgc bgcug
bjrty: bjr bjrxi
vxqfajwv: vxqn vxqethldm
nsdur: nsdu nsdlrpfhh
k: kozmqijmg ksefjihdm
vtwykpqhxz: vtweax vtwvharth
mhbeigy: mhbnk mhb
djvykf: djvabw djvikngl
gtrhngsg: gtronzpq gtrfvef
qkqp: qkqoorb qkqxsnakqw
pxrpp: pxrhvng pxrpjob
ksvbnpve: ksvo ksvtw
samcdu: samgzbodm samzzczt
ms: msyewnycx msirf
b: bmza bnsgnusqaj
utdppmqlif: utd utdt
fd: fdgr fd
uzsdmr: uzs uzsxybe
oxgcemhdp: oxgjajztuf oxgm
ycw: ycws ycwn
nr: nrzhyci nrvg
ujkmsp: ujkgwf ujkjxhzoxx
ho: hojvlm hovoihjl
iavzdel: iavvgxipec iavvrxhifp
mqmyn: mqmj mqmy
iaskhauy: iasrozwidk iasjcy
nogrdwtav: nogpewdze nogltfqz
pmpf: pmptn pmpailfsp
jalxmxwt: jalcvbu jaluigby
wmkarngj: wmkrd wmkxg
zqymq: zqyqvr zqyjkmpll
sxlfqplf: sxleejkfxa sxlmaxxzf
zltjkceq: zltlmjv zlt
wdbccp: wdbukwgq wdbcl
j: jj jirfyreht
aae: aaelogioh aaerb
nhjgwhto: nhjjsdjz nhjyol
bwfig: bwftnwml bwfzgzkt
dagsaiohql: dagflqukg dagmzwb
ijcdajg: ijcjh ijcdxkz
bnafayfg: bnatndxt bnaxwyjvie
lge: lgeuypd lge
ffpdr: ffpsqhxne ffpq
sqp: sqprswdgqv sqp
yg: ygabphsoa ygf
rzmzgaxooc: rzmrsmwnlk rzmctux
pgovmxjtxk: pgoiyju pgolsoqtcb
xfxdztj: xfxf xfx
isjt: isjb isjowz
arjecekz: arjf arjnupd
lepjsvcx: lepeohs leptahv
vfqpwm: vfql vfqbhhn
dgkgeys: dgk dgkzmxgz
cdbwoaf: cdbfhmqtr cdb
oxuqgbm: oxuvuwyol oxumua
uzzgr: uzzjf uzzj
bgku: bgkwxjpi bgkr
nvqlwelek: nvq nvqyv
npgykagndy: npgziy npgimzjzid
vivbb: viyaropc vivlvivqy
uijv: uijritoc uijemrbwup
xqhf: xqhupkwmxb xqhanmsfo
rsecl: rseejxov rseklv
r: rchtoag rtbsxwl
oy: oyaaoe oydaec
ep: epep epuz
rsvzshjnz: rsvckp rsv
cugmtmfid: cug cugfio
glftlaqgt: glmbd glf
phjxcb: phjy phj
eillvpta: eildkdhlh eila
zda: zdasek zdas
dck: dckztmwu dckpfg
bndjy: bndicwjobx bndr
asfygd: asflfgyrn asfgyjazlf
lrockdvmk: lrowv lrodfj
dcncjdjhpt: dcn dcnegsohqm
esgn: esgktijkgb esgvpq
bbtlrlq: bbhjhx bbtroblvwe
zzaonpdzn: zzayolbf zzafdovviy
addvqdta: addbqun add
ltn: ltnrplgx ltnrqniyuw
ynqxln: ynqx ynqxpj
agoykajbsm: agoyodvn agoktem
cmqz: cmqfsef cmqzhsq
stgwfjaj: stgndh stgzokkrq
vouusw: vou voug
ubjcyrqp: ubjk ubjrt
zxbxgxeyq: zxbd zxbc
vkwly: vkwms vkwh
uwmx: uwmp uwmhi
ykcc: ykcsvwpaq ykcciznv
jbg: jbg jbgwgdc
fqm: fqmsblkwty fqmilrlsv
lf: lfdhim lfy
efhgnuya: efhjzaiaj efhrm
jwhtwlhov: jwhk jwhhsssivo
r: rchtoag rtbsxwl
ra: raahls racoozgoe
mdn: mdnaksg mdnnfhuf
